class                    =  0: bool [edible poisonous];	# card 2
cap-shape                =  1: enum string [bell conical convex flat knobbed sunken];	# card 6
cap-surface              =  2: enum string [fibrous grooves scaly smooth];	# card 4
cap-color                =  3: enum string [brown buff cinnamon gray green pink purple red white yellow];	# card 10
bruises                  =  4: bool [no yes];	# card 2
odor                     =  5: enum string [almond anise creosote fishy foul musty none pungent spicy];	# card 9
gill-attachment          =  6: bool [attached free];	# card 2
gill-spacing             =  7: bool [close crowded];	# card 2
gill-size                =  8: bool [broad narrow];	# card 2
gill-color               =  9: enum string [black brown buff chocolate gray green orange pink purple red white yellow];	# card 12
stalk-shape              = 10: bool [enlarging tapering];	# card 2
stalk-root               = 11: enum string [? bulbous club equal rooted];	# card 5
stalk-surface-above-ring = 12: enum string [fibrous scaly silky smooth];	# card 4
stalk-surface-below-ring = 13: enum string [fibrous scaly silky smooth];	# card 4
stalk-color-above-ring   = 14: enum string [brown buff cinnamon gray orange pink red white yellow];	# card 9
stalk-color-below-ring   = 15: enum string [brown buff cinnamon gray orange pink red white yellow];	# card 9
veil-type                = 16: enum string [partial];	# card 1
veil-color               = 17: enum string [brown orange white yellow];	# card 4
ring-number              = 18: enum string [none one two];	# card 3
ring-type                = 19: enum string [evanescent flaring large none pendant];	# card 5
spore-print-color        = 20: enum string [black brown buff chocolate green orange purple white yellow];	# card 9
population               = 21: enum string [abundant clustered numerous scattered several solitary];	# card 6
habitat                  = 22: enum string [grasses leaves meadows paths urban waste woods];	# card 7
